1 40 90
############
#    #   . #
#          #
#  $@   #  #
#  # $$ #  #
# .#.      #
############