1 99 2
 ####################
##     @            #
#   .        $      #
# $ $               #
#.        .         #
#####################