1 99 1
 ###############
##     $       #
#   .      $   #
# $     @      #
#.      .      #
################