6 9 3 8
##############
#            #
#   @#       #
#  ###       #
#  $   $ .   #
#        .   #
#  $   ###   #
#      #. $  #
#  .         #
##############