1 99 30
 ###########
##.    $   #
#          #
# $ $      #
#. @      .#
############