1 99 3
 #####################
##        #         #
#   ##########  $   #
# $ $     @         #
#.        .       . #
#####################