10 20 30 10
###########
##       ##
## ## ## ##
##       ##
###  #  ###
#  .$#$.  #
# #  @  # #
#  .$#$.  #
###  #  ###
###########