1 99 30 20
 ################
##.    $       .#
#          $    #
# $ $      ######
#. @      .#
############