4 10 6 2 
#########
#.#.#.#.#
# # # # #  
# # # # #
# # # # #
# $ $ $ #
#   $   #
#   @   #
#########