10 60
###############
#+         # .#
# ##  ######  #
# # $ #   $   #
#       ###   #
###############