1 99
#######
#  @  #
# $#  #
# .#$ #
#  #  #
#.    #
#######
