6 9
###########
#  @#     #
# ####### #
#         #
# $  ###  #
#    #. $ #
# .  #    #
###########