1 5
######
#@   ##
# $$  #
# #. .#
# #   #
#######